36 12
110010000011111110101001001001101010
111100100000000010100011011000000100
110001111000101110100010001111111111
111001000010100001100001101011101101
1101000S0001101100000101011001000100
000111011110101001100101101001101101
001001010111110001101000100011101001
110000001101101101000001101111010111
10011000101100001001100E100100010101
011110000001111100001010101001110011
001100010111110010101111111001100000
110001100111010010100101111001100010