10 7
0101E00000
0100110110
0101010000
0100100101
S101111000
0000000001
1111111111