8 5
0001E001
01001101
01000000
01001000
S1110111