10 10
000S100000
0001100000
1011000000
0010000010
0010011110
0000100000
0000100010
0001110000
0000001100
0000001E00